NO ./assets/texture/daram.xpm
SO ./assets/texture/louna.xpm
WE ./assets/texture/oceane.xpm
EA ./assets/texture/kelly.xpm


F  118,22,22
C  150,155,155

          11111111111111111111111
         1000000000110000000000001
         1011000001110000000000001
11111111 10000N000000000111111111
 11111111011000001110000000000001
10000000001100011011011111111111
 111011111  101  100000010001
  110111  11101  101010010001
 10000001101001  100000010001
1000000000000001100000010001
10000000000000001101010010001
 10000011101010111110111100111
  11011   110101 1011 1010001
    1       1 1   1    1 111