NO ./path_to_the_north_texture
SO ./path_to_the_south_texture
WE ./path_to_the_west_texture
EA ./path_to_the_east_texture

F 220,100,0   
C 255,30,0   

          11111111111111111111111
         1000000000110000000000001
         1011000001110000000000001
11111111 100000000000000111111111
 11111111011000001110000000000001
10000000001100011011011111111111
 111011111  101  100000010001
  110111  11101  101010010001
 10000001101001  100000010001
1000000000000001100000010001
10000000000000001101010010001
 1000001110101011111011110N0111
  11011   110101 1011 1010001
    1       1 1   1    1 111